##########
#      #E#
#        #
#        #
#S       #
##########
