##########
#S# # #E #
# # # #  #
# ###### #
#        #
##########
